###S..#.#..####
..##.#..#.#.#..
#..#..#......#.
.#.##.##.#.#...
......#.#G.##.#
###..#...#.#...
#...#..#.##..#.
..#...#..#.....
.#.###.#..#.##.
....#...#.#.#..
#.##..###..#...
..#.#....##..##
.#..#.#.#.#....
...#...#....#.#
##...#...#.#...
